,STNAME,CoC Code,Coc,FIPS code,CTYNAME,Year,Population,Male,Female,White,Black or African American,American Indian and Alaska Native,Asian,Native Hawaiian and Other Pacific Islander,Two or More Races,Non Hispanic,Hispanic
24,Colorado,CO-503,Metropolitan Denver,8001,Adams County,2007,419607,212949,206658,376535,14829,5760,14041,673,7769,273024,146583
25,Colorado,CO-503,Metropolitan Denver,8001,Adams County,2008,429597,217985,211612,384965,15461,5852,14517,725,8077,278215,151382
26,Colorado,CO-503,Metropolitan Denver,8001,Adams County,2009,440994,223812,217182,394926,15960,6066,14819,743,8480,283358,157636
27,Colorado,CO-503,Metropolitan Denver,8001,Adams County,2010,441603,222142,219461,387643,15143,9387,16830,858,11742,273725,167878
184,Colorado,CO-503,Metropolitan Denver,8001,Adams County,2011,452209,227299,224910,396190,15610,9578,17550,968,12313,278703,173506
185,Colorado,CO-503,Metropolitan Denver,8001,Adams County,2012,460568,231260,229308,402512,16117,9744,18332,1007,12856,283492,177076
186,Colorado,CO-503,Metropolitan Denver,8001,Adams County,2013,469995,236190,233805,409363,16943,10010,19042,1041,13596,288457,181538
187,Colorado,CO-503,Metropolitan Denver,8001,Adams County,2014,479954,241458,238496,417058,17677,10232,19777,1089,14121,293573,186381
188,Colorado,CO-503,Metropolitan Denver,8001,Adams County,2015,490448,247076,243372,424712,18393,10749,20713,1094,14787,298253,192195
189,Colorado,CO-503,Metropolitan Denver,8001,Adams County,2016,497735,250849,246886,429565,19128,11019,21370,1143,15510,300810,196925
190,Colorado,CO-503,Metropolitan Denver,8001,Adams County,2017,503717,254323,249394,433189,19687,11551,22011,1189,16090,302686,201031
191,Colorado,CO-503,Metropolitan Denver,8001,Adams County,2018,511485,258304,253181,438830,20225,11838,22895,1205,16492,305097,206388
192,Colorado,CO-503,Metropolitan Denver,8001,Adams County,2019,516575,261156,255419,441767,21072,12353,23240,1243,16900,306195,210380
193,Colorado,CO-503,Metropolitan Denver,8001,Adams County,2020,519883,262601,257282,443705,21390,12594,23533,1269,17392,305779,214104
440,Colorado,CO-503,Metropolitan Denver,8001,Adams County,2021,522140,265179,256961,444924,21728,12748,23655,1355,17730,303744,218396
28,Colorado,CO-503,Metropolitan Denver,8005,Arapahoe County,2007,543414,267904,275510,446786,53236,4455,24801,923,13213,451685,91729
29,Colorado,CO-503,Metropolitan Denver,8005,Arapahoe County,2008,554372,273593,280779,454854,54901,4616,25399,947,13655,458515,95857
30,Colorado,CO-503,Metropolitan Denver,8005,Arapahoe County,2009,565360,279177,286183,462017,57025,4729,26419,960,14210,466285,99075
31,Colorado,CO-503,Metropolitan Denver,8005,Arapahoe County,2010,572003,280345,291658,453937,60748,6392,29930,1355,19641,466481,105522
194,Colorado,CO-503,Metropolitan Denver,8005,Arapahoe County,2011,586433,287441,298992,464073,62386,6394,31466,1407,20707,477448,108985
195,Colorado,CO-503,Metropolitan Denver,8005,Arapahoe County,2012,597052,292872,304180,470688,64195,6462,32773,1401,21533,486602,110450
196,Colorado,CO-503,Metropolitan Denver,8005,Arapahoe County,2013,609089,299125,309964,477865,66138,6643,34375,1534,22534,495940,113149
197,Colorado,CO-503,Metropolitan Denver,8005,Arapahoe County,2014,619681,305010,314671,484179,68113,6733,35785,1628,23243,504005,115676
198,Colorado,CO-503,Metropolitan Denver,8005,Arapahoe County,2015,631688,311482,320206,490252,70157,6937,38114,1804,24424,513239,118449
199,Colorado,CO-503,Metropolitan Denver,8005,Arapahoe County,2016,639605,316109,323496,494093,71695,7107,39757,1915,25038,518606,120999
200,Colorado,CO-503,Metropolitan Denver,8005,Arapahoe County,2017,645080,319190,325890,496108,72850,7427,40947,1990,25758,521223,123857
201,Colorado,CO-503,Metropolitan Denver,8005,Arapahoe County,2018,652395,323088,329307,499441,74460,7603,42465,2033,26393,525694,126701
202,Colorado,CO-503,Metropolitan Denver,8005,Arapahoe County,2019,656051,325369,330682,500729,75482,7765,43025,2139,26911,526663,129388
203,Colorado,CO-503,Metropolitan Denver,8005,Arapahoe County,2020,657452,326642,330810,500026,76306,7796,43578,2196,27550,525792,131660
441,Colorado,CO-503,Metropolitan Denver,8005,Arapahoe County,2021,654900,327434,327466,496029,77041,8027,43439,2227,28137,520174,134726
32,Colorado,CO-503,Metropolitan Denver,8013,Boulder County,2007,295691,149578,146113,274009,3449,2252,10922,218,4841,257368,38323
33,Colorado,CO-503,Metropolitan Denver,8013,Boulder County,2008,300452,152137,148315,278139,3615,2320,11144,224,5010,260647,39805
34,Colorado,CO-503,Metropolitan Denver,8013,Boulder County,2009,303482,153726,149756,280573,3777,2328,11405,230,5169,262498,40984
35,Colorado,CO-503,Metropolitan Denver,8013,Boulder County,2010,294567,147916,146651,270093,2814,2392,12367,213,6688,255291,39276
204,Colorado,CO-503,Metropolitan Denver,8013,Boulder County,2011,300045,150442,149603,274047,2982,2580,13055,231,7150,259491,40554
205,Colorado,CO-503,Metropolitan Denver,8013,Boulder County,2012,304717,152818,151899,277995,3086,2547,13417,234,7438,263428,41289
206,Colorado,CO-503,Metropolitan Denver,8013,Boulder County,2013,309538,155292,154246,281713,3218,2663,13955,236,7753,267431,42107
207,Colorado,CO-503,Metropolitan Denver,8013,Boulder County,2014,312525,156892,155633,283858,3360,2648,14480,229,7950,270084,42441
208,Colorado,CO-503,Metropolitan Denver,8013,Boulder County,2015,318408,159993,158415,288526,3420,2749,15081,233,8399,274914,43494
209,Colorado,CO-503,Metropolitan Denver,8013,Boulder County,2016,321761,161758,160003,290995,3553,2751,15546,239,8677,277757,44004
210,Colorado,CO-503,Metropolitan Denver,8013,Boulder County,2017,323019,162551,160468,291683,3641,2782,15835,230,8848,278425,44594
211,Colorado,CO-503,Metropolitan Denver,8013,Boulder County,2018,325438,163779,161659,293461,3704,2856,16071,238,9108,280461,44977
212,Colorado,CO-503,Metropolitan Denver,8013,Boulder County,2019,326020,164167,161853,293627,3866,2896,16124,244,9263,280902,45118
213,Colorado,CO-503,Metropolitan Denver,8013,Boulder County,2020,327171,164664,162507,294333,3949,2927,16259,251,9452,281867,45304
442,Colorado,CO-503,Metropolitan Denver,8013,Boulder County,2021,329543,166604,162939,296250,4071,2955,16365,263,9639,283163,46380
80,New York,NY-600,New York City,36005,Bronx County,2007,1385122,649464,735658,688718,595208,15826,51679,3570,30121,676689,708433
81,New York,NY-600,New York City,36005,Bronx County,2008,1389315,652276,737039,689262,597631,16051,52116,3612,30643,673657,715658
82,New York,NY-600,New York City,36005,Bronx County,2009,1397287,656983,740304,691992,601273,16346,52686,3672,31318,671022,726265
83,New York,NY-600,New York City,36005,Bronx County,2010,1385108,649633,735475,630493,607289,41052,57062,5766,43446,643695,741413
324,New York,NY-600,New York City,36005,Bronx County,2011,1396954,655910,741044,634920,612071,41658,57728,5878,44699,641352,755602
325,New York,NY-600,New York City,36005,Bronx County,2012,1411087,662701,748386,641325,617073,42082,58782,5950,45875,640724,770363
326,New York,NY-600,New York City,36005,Bronx County,2013,1421498,668584,752914,643288,623101,42377,59630,5978,47124,640451,781047
327,New York,NY-600,New York City,36005,Bronx County,2014,1430474,672915,757559,645084,627741,42677,60712,6018,48242,640500,789974
328,New York,NY-600,New York City,36005,Bronx County,2015,1439480,677679,761801,647541,631259,42786,62234,6068,49592,640887,798593
329,New York,NY-600,New York City,36005,Bronx County,2016,1443678,680419,763259,646173,633881,43203,63585,6149,50687,639315,804363
330,New York,NY-600,New York City,36005,Bronx County,2017,1439956,678904,761052,642926,631789,43184,64721,6143,51193,635992,803964
331,New York,NY-600,New York City,36005,Bronx County,2018,1432316,675607,756709,637810,628200,42849,65440,6104,51913,629649,802667
332,New York,NY-600,New York City,36005,Bronx County,2019,1418187,669312,748875,628425,622927,42787,65794,6052,52202,621178,797009
333,New York,NY-600,New York City,36005,Bronx County,2020,1401142,660913,740229,618441,616104,42500,65520,6045,52532,610322,790820
454,New York,NY-600,New York City,36005,Bronx County,2021,1424948,675715,749233,630892,623813,43490,66999,6138,53616,620826,804122
36,Colorado,CO-503,Metropolitan Denver,8014,Broomfield County,2007,53664,27005,26659,48964,644,373,2741,18,924,47615,6049
37,Colorado,CO-503,Metropolitan Denver,8014,Broomfield County,2008,54813,27602,27211,49903,736,395,2790,18,971,48532,6281
38,Colorado,CO-503,Metropolitan Denver,8014,Broomfield County,2009,55990,28228,27762,50899,764,406,2892,18,1011,49527,6463
39,Colorado,CO-503,Metropolitan Denver,8014,Broomfield County,2010,55889,27729,28160,50002,631,426,3479,45,1306,49673,6216
214,Colorado,CO-503,Metropolitan Denver,8014,Broomfield County,2011,57485,28484,29001,51292,700,449,3651,53,1340,51001,6484
215,Colorado,CO-503,Metropolitan Denver,8014,Broomfield County,2012,58971,29290,29681,52674,714,479,3675,57,1372,52116,6855
216,Colorado,CO-503,Metropolitan Denver,8014,Broomfield County,2013,60158,29774,30384,53693,747,456,3749,61,1452,53096,7062
217,Colorado,CO-503,Metropolitan Denver,8014,Broomfield County,2014,61791,30554,31237,54975,808,466,3922,77,1543,54485,7306
218,Colorado,CO-503,Metropolitan Denver,8014,Broomfield County,2015,64914,32185,32729,57652,906,531,4087,83,1655,57095,7819
219,Colorado,CO-503,Metropolitan Denver,8014,Broomfield County,2016,66596,32985,33611,58838,957,521,4342,97,1841,58473,8123
220,Colorado,CO-503,Metropolitan Denver,8014,Broomfield County,2017,68340,34008,34332,60088,1063,563,4572,99,1955,59863,8477
221,Colorado,CO-503,Metropolitan Denver,8014,Broomfield County,2018,69431,34587,34844,60986,1064,563,4716,96,2006,60629,8802
222,Colorado,CO-503,Metropolitan Denver,8014,Broomfield County,2019,70617,35170,35447,61928,1070,570,4839,99,2111,61611,9006
223,Colorado,CO-503,Metropolitan Denver,8014,Broomfield County,2020,72236,36141,36095,63075,1189,584,5080,94,2214,62900,9336
443,Colorado,CO-503,Metropolitan Denver,8014,Broomfield County,2021,75325,37922,37403,65578,1276,626,5444,119,2282,65160,10165
76,Nevada,NV-500,Las Vegas/Clark County,32003,Clark County,2007,1838635,935014,903621,1428739,191062,19279,135370,11057,53128,1322530,516105
77,Nevada,NV-500,Las Vegas/Clark County,32003,Clark County,2008,1879093,956353,922740,1453258,197272,19756,141921,11484,55402,1339837,539256
78,Nevada,NV-500,Las Vegas/Clark County,32003,Clark County,2009,1902834,968208,934626,1467023,201467,20020,145672,11660,56992,1345567,557267
79,Nevada,NV-500,Las Vegas/Clark County,32003,Clark County,2010,1951269,982193,969076,1445825,215789,22542,175627,15616,75870,1382625,568644
314,Nevada,NV-500,Las Vegas/Clark County,32003,Clark County,2011,1962162,985526,976636,1444666,219513,22597,180694,15927,78765,1383694,578468
315,Nevada,NV-500,Las Vegas/Clark County,32003,Clark County,2012,1989644,998851,990793,1455351,227005,23046,185957,16207,82078,1399001,590643
316,Nevada,NV-500,Las Vegas/Clark County,32003,Clark County,2013,2017798,1011520,1006278,1466708,232376,23351,193037,16798,85528,1412827,604971
317,Nevada,NV-500,Las Vegas/Clark County,32003,Clark County,2014,2053929,1028127,1025802,1482373,240501,23999,200125,17235,89696,1433446,620483
318,Nevada,NV-500,Las Vegas/Clark County,32003,Clark County,2015,2097832,1048791,1049041,1501661,251575,24762,207783,17774,94277,1457718,640114
319,Nevada,NV-500,Las Vegas/Clark County,32003,Clark County,2016,2140240,1069022,1071218,1517935,263625,25455,215257,18648,99320,1481671,658569
320,Nevada,NV-500,Las Vegas/Clark County,32003,Clark County,2017,2183273,1089565,1093708,1533787,276367,26197,222981,19385,104556,1506060,677213
321,Nevada,NV-500,Las Vegas/Clark County,32003,Clark County,2018,2228970,1111829,1117141,1553938,288360,27067,229774,20175,109656,1531847,697123
322,Nevada,NV-500,Las Vegas/Clark County,32003,Clark County,2019,2275884,1134237,1141647,1574433,298891,28000,238433,21020,115107,1557841,718043
323,Nevada,NV-500,Las Vegas/Clark County,32003,Clark County,2020,2315963,1153732,1162231,1590696,307805,28734,247040,21654,120034,1579140,736823
453,Nevada,NV-500,Las Vegas/Clark County,32003,Clark County,2021,2292476,1147762,1144714,1558762,312095,28823,248779,21903,122114,1551173,741303
64,Illinois,IL-510,Chicago,17031,Cook County,2007,5235762,2545196,2690566,3487081,1360091,21448,299158,5635,62349,4061314,1174448
65,Illinois,IL-510,Chicago,17031,Cook County,2008,5256705,2557064,2699641,3504708,1353807,22145,305909,5814,64322,4058844,1197861
66,Illinois,IL-510,Chicago,17031,Cook County,2009,5287037,2572999,2714038,3527789,1350766,22967,312868,6028,66619,4062448,1224589
67,Illinois,IL-510,Chicago,17031,Cook County,2010,5194675,2514314,2680361,3420279,1311698,39890,332803,4007,85998,3949913,1244762
284,Illinois,IL-510,Chicago,17031,Cook County,2011,5219636,2527304,2692332,3434494,1306124,39648,346528,3838,89004,3956502,1263134
285,Illinois,IL-510,Chicago,17031,Cook County,2012,5239105,2536984,2702121,3443645,1302933,39654,357613,3873,91387,3963635,1275470
286,Illinois,IL-510,Chicago,17031,Cook County,2013,5252513,2544509,2708004,3449199,1296161,39397,369678,3872,94206,3966514,1285999
287,Illinois,IL-510,Chicago,17031,Cook County,2014,5254108,2546443,2707665,3446472,1288510,39264,379384,3873,96605,3959271,1294837
288,Illinois,IL-510,Chicago,17031,Cook County,2015,5243371,2542404,2700967,3434526,1279297,39196,387848,3843,98661,3941658,1301713
289,Illinois,IL-510,Chicago,17031,Cook County,2016,5223386,2534363,2689023,3418620,1267198,38854,394143,3795,100776,3917038,1306348
290,Illinois,IL-510,Chicago,17031,Cook County,2017,5199582,2524099,2675483,3400330,1251668,38566,402770,3729,102519,3891551,1308031
291,Illinois,IL-510,Chicago,17031,Cook County,2018,5171007,2510637,2660370,3377117,1239247,38248,408133,3744,104518,3862041,1308966
292,Illinois,IL-510,Chicago,17031,Cook County,2019,5145326,2498446,2646880,3354894,1230039,38422,411985,3741,106245,3836051,1309275
293,Illinois,IL-510,Chicago,17031,Cook County,2020,5108284,2481079,2627205,3325506,1219493,38488,413443,3735,107619,3798745,1309539
450,Illinois,IL-510,Chicago,17031,Cook County,2021,5173146,2525814,2647332,3373515,1226143,39482,418482,3690,111834,3826562,1346584
40,Colorado,CO-503,Metropolitan Denver,8031,Denver County,2007,578789,292763,286026,477944,60896,8076,19454,1316,11103,383220,195569
41,Colorado,CO-503,Metropolitan Denver,8031,Denver County,2008,593086,300168,292918,489896,61681,8235,20239,1410,11625,393058,200028
42,Colorado,CO-503,Metropolitan Denver,8031,Denver County,2009,610345,309088,301257,504743,62382,8456,21147,1528,12089,403417,206928
43,Colorado,CO-503,Metropolitan Denver,8031,Denver County,2010,600158,300089,300069,483271,64518,12515,21403,899,17552,409193,190965
224,Colorado,CO-503,Metropolitan Denver,8031,Denver County,2011,620250,309586,310664,500096,65326,12687,22771,900,18470,424514,195736
225,Colorado,CO-503,Metropolitan Denver,8031,Denver County,2012,634965,317111,317854,512022,66268,12672,23706,1088,19209,436632,198333
226,Colorado,CO-503,Metropolitan Denver,8031,Denver County,2013,649270,324332,324938,523313,67196,12909,24655,1143,20054,448251,201019
227,Colorado,CO-503,Metropolitan Denver,8031,Denver County,2014,664540,332128,332412,535454,68436,13000,25681,1149,20820,459636,204904
228,Colorado,CO-503,Metropolitan Denver,8031,Denver County,2015,683328,342179,341149,551267,69508,13032,26724,1191,21606,475241,208087
229,Colorado,CO-503,Metropolitan Denver,8031,Denver County,2016,696273,348921,347352,562022,69902,13198,27610,1239,22302,486556,209717
230,Colorado,CO-503,Metropolitan Denver,8031,Denver County,2017,704869,353045,351824,569446,69789,13086,28353,1329,22866,494630,210239
231,Colorado,CO-503,Metropolitan Denver,8031,Denver County,2018,716340,359387,356953,578098,70815,13056,29112,1504,23755,504606,211734
232,Colorado,CO-503,Metropolitan Denver,8031,Denver County,2019,725508,363739,361769,586257,71027,12915,29479,1517,24313,513494,212014
233,Colorado,CO-503,Metropolitan Denver,8031,Denver County,2020,735538,368867,366671,594047,71866,13037,30001,1616,24971,522803,212735
444,Colorado,CO-503,Metropolitan Denver,8031,Denver County,2021,711463,358381,353082,573034,70184,12675,29052,1701,24817,505256,206207
52,District of Columbia,DC-500,District of Columbia,11001,District of Columbia,2007,586409,276503,309906,227714,329278,2190,17894,535,8798,537656,48753
53,District of Columbia,DC-500,District of Columbia,11001,District of Columbia,2008,590074,278503,311571,233621,325972,2255,18501,570,9155,539594,50480
54,District of Columbia,DC-500,District of Columbia,11001,District of Columbia,2009,599657,283063,316594,243617,323931,2352,19437,590,9730,546632,53025
55,District of Columbia,DC-500,District of Columbia,11001,District of Columbia,2010,601723,284222,317501,251265,310379,3264,21705,770,14340,546974,54749
254,District of Columbia,DC-500,District of Columbia,11001,District of Columbia,2011,620290,293695,326595,263669,314236,3413,22884,862,15226,560614,59676
255,District of Columbia,DC-500,District of Columbia,11001,District of Columbia,2012,635737,301023,334714,273652,317686,3530,23929,960,15980,572788,62949
256,District of Columbia,DC-500,District of Columbia,11001,District of Columbia,2013,651559,309137,342422,282152,322616,3851,25104,1011,16825,584981,66578
257,District of Columbia,DC-500,District of Columbia,11001,District of Columbia,2014,663603,315215,348388,289837,325302,3966,26062,1051,17385,594283,69320
258,District of Columbia,DC-500,District of Columbia,11001,District of Columbia,2015,677014,321166,355848,298776,327506,4047,27585,1081,18019,604676,72338
259,District of Columbia,DC-500,District of Columbia,11001,District of Columbia,2016,687576,326511,361065,306130,328588,4177,28903,1111,18667,613167,74409
260,District of Columbia,DC-500,District of Columbia,11001,District of Columbia,2017,697079,330743,366336,313408,328809,4246,30145,1110,19361,620751,76328
261,District of Columbia,DC-500,District of Columbia,11001,District of Columbia,2018,704147,334326,369821,319355,328536,4264,30945,1138,19909,625930,78217
262,District of Columbia,DC-500,District of Columbia,11001,District of Columbia,2019,708253,335860,372393,324529,326019,4318,31697,1100,20590,628415,79838
263,District of Columbia,DC-500,District of Columbia,11001,District of Columbia,2020,712816,337932,374884,329706,324186,4240,32460,1089,21135,631701,81115
447,District of Columbia,DC-500,District of Columbia,11001,District of Columbia,2021,670050,318904,351146,307274,306925,4067,30342,1063,20379,593131,76919
44,Colorado,CO-503,Metropolitan Denver,8035,Douglas County,2007,271955,136282,135673,251527,4866,1375,9540,162,4485,252517,19438
45,Colorado,CO-503,Metropolitan Denver,8035,Douglas County,2008,281138,140917,140221,259561,5142,1416,10080,167,4772,260786,20352
46,Colorado,CO-503,Metropolitan Denver,8035,Douglas County,2009,288225,144478,143747,265615,5385,1452,10584,170,5019,267299,20926
47,Colorado,CO-503,Metropolitan Denver,8035,Douglas County,2010,285465,141253,144212,262954,3671,1387,10908,240,6305,264073,21392
234,Colorado,CO-503,Metropolitan Denver,8035,Douglas County,2011,292626,144915,147711,269140,3735,1348,11531,264,6608,269831,22795
235,Colorado,CO-503,Metropolitan Denver,8035,Douglas County,2012,298826,148130,150696,274275,3778,1329,12183,311,6950,274948,23878
236,Colorado,CO-503,Metropolitan Denver,8035,Douglas County,2013,306407,151921,154486,280643,3921,1407,12765,331,7340,281730,24677
237,Colorado,CO-503,Metropolitan Denver,8035,Douglas County,2014,314783,156347,158436,287448,4060,1419,13787,351,7718,289114,25669
238,Colorado,CO-503,Metropolitan Denver,8035,Douglas County,2015,322333,160250,162083,293431,4226,1501,14790,351,8034,295596,26737
239,Colorado,CO-503,Metropolitan Denver,8035,Douglas County,2016,328680,163905,164775,298032,4533,1555,15822,362,8376,300872,27808
240,Colorado,CO-503,Metropolitan Denver,8035,Douglas County,2017,336347,167936,168411,303628,4955,1626,16887,361,8890,307166,29181
241,Colorado,CO-503,Metropolitan Denver,8035,Douglas County,2018,343780,171765,172015,308743,5338,1774,18202,369,9354,313031,30749
242,Colorado,CO-503,Metropolitan Denver,8035,Douglas County,2019,351842,175738,176104,314549,5791,1868,19189,397,10048,319744,32098
243,Colorado,CO-503,Metropolitan Denver,8035,Douglas County,2020,360750,180324,180426,321374,6251,1920,20214,420,10571,326961,33789
445,Colorado,CO-503,Metropolitan Denver,8035,Douglas County,2021,368990,185806,183184,327309,6860,2055,21348,469,10949,333028,35962
112,Texas,TX-700,"Houston, Pasadena, Conroe/Harris, Ft. Bend, Montgomery",48157,Fort Bend County,2007,508260,253561,254699,316316,108254,2173,73844,283,7390,389649,118611
113,Texas,TX-700,"Houston, Pasadena, Conroe/Harris, Ft. Bend, Montgomery",48157,Fort Bend County,2008,532609,265956,266653,330162,112208,2354,79471,300,8114,406797,125812
114,Texas,TX-700,"Houston, Pasadena, Conroe/Harris, Ft. Bend, Montgomery",48157,Fort Bend County,2009,556870,278203,278667,343336,117245,2547,84598,318,8826,424448,132422
115,Texas,TX-700,"Houston, Pasadena, Conroe/Harris, Ft. Bend, Montgomery",48157,Fort Bend County,2010,585375,287368,298007,340821,128309,3442,101685,410,10708,446408,138967
404,Texas,TX-700,"Houston, Pasadena, Conroe/Harris, Ft. Bend, Montgomery",48157,Fort Bend County,2011,605979,297802,308177,351693,131111,3556,107904,464,11251,461372,144607
405,Texas,TX-700,"Houston, Pasadena, Conroe/Harris, Ft. Bend, Montgomery",48157,Fort Bend County,2012,624737,306560,318177,361127,133956,3605,113647,497,11905,475251,149486
406,Texas,TX-700,"Houston, Pasadena, Conroe/Harris, Ft. Bend, Montgomery",48157,Fort Bend County,2013,651770,320323,331447,375527,138574,3779,120493,517,12880,495936,155834
407,Texas,TX-700,"Houston, Pasadena, Conroe/Harris, Ft. Bend, Montgomery",48157,Fort Bend County,2014,683977,336223,347754,391079,144347,4012,130130,551,13858,520499,163478
408,Texas,TX-700,"Houston, Pasadena, Conroe/Harris, Ft. Bend, Montgomery",48157,Fort Bend County,2015,715260,351623,363637,405313,149661,4174,140683,626,14803,544307,170953
409,Texas,TX-700,"Houston, Pasadena, Conroe/Harris, Ft. Bend, Montgomery",48157,Fort Bend County,2016,744489,365925,378564,417424,155819,4408,150327,659,15852,564836,179653
410,Texas,TX-700,"Houston, Pasadena, Conroe/Harris, Ft. Bend, Montgomery",48157,Fort Bend County,2017,768258,377247,391011,425725,161474,4675,159105,676,16603,581444,186814
411,Texas,TX-700,"Houston, Pasadena, Conroe/Harris, Ft. Bend, Montgomery",48157,Fort Bend County,2018,789269,387158,402111,433157,167120,4834,166146,681,17331,595594,193675
412,Texas,TX-700,"Houston, Pasadena, Conroe/Harris, Ft. Bend, Montgomery",48157,Fort Bend County,2019,812737,398648,414089,441506,173956,4944,173027,763,18541,611356,201381
413,Texas,TX-700,"Houston, Pasadena, Conroe/Harris, Ft. Bend, Montgomery",48157,Fort Bend County,2020,839706,411851,427855,451937,181720,5167,180564,838,19480,629483,210223
462,Texas,TX-700,"Houston, Pasadena, Conroe/Harris, Ft. Bend, Montgomery",48157,Fort Bend County,2021,858527,423160,435367,458561,187748,5498,185480,883,20357,639666,218861
60,Georgia,GA-500,Atlanta,13121,Fulton County,2007,990790,487498,503292,505858,426112,3820,41406,982,12612,910596,80194
61,Georgia,GA-500,Atlanta,13121,Fulton County,2008,1013356,498878,514478,514776,436611,4099,43316,1091,13463,928504,84852
62,Georgia,GA-500,Atlanta,13121,Fulton County,2009,1033756,509169,524587,523155,445660,4365,45174,1191,14211,943927,89829
63,Georgia,GA-500,Atlanta,13121,Fulton County,2010,920581,448267,472314,436938,410748,3280,52629,508,16478,848015,72566
274,Georgia,GA-500,Atlanta,13121,Fulton County,2011,947582,461296,486286,444793,425722,3139,55908,483,17537,875082,72500
275,Georgia,GA-500,Atlanta,13121,Fulton County,2012,973464,473742,499722,454762,436648,3226,59778,547,18503,900346,73118
276,Georgia,GA-500,Atlanta,13121,Fulton County,2013,981844,476967,504877,456731,439251,3084,62995,571,19212,909330,72514
277,Georgia,GA-500,Atlanta,13121,Fulton County,2014,992321,481525,510796,459590,443787,3067,65635,564,19678,920116,72205
278,Georgia,GA-500,Atlanta,13121,Fulton County,2015,1005752,486746,519006,463464,449855,2959,68733,568,20173,933479,72273
279,Georgia,GA-500,Atlanta,13121,Fulton County,2016,1023816,496134,527682,469897,456558,3030,72817,591,20923,950427,73389
280,Georgia,GA-500,Atlanta,13121,Fulton County,2017,1039996,503642,536354,475306,463324,2921,76462,596,21387,965837,74159
281,Georgia,GA-500,Atlanta,13121,Fulton County,2018,1051516,509273,542243,479036,467428,2911,79350,567,22224,976271,75245
282,Georgia,GA-500,Atlanta,13121,Fulton County,2019,1065019,515023,549996,483516,472909,2921,82089,471,23113,988727,76292
283,Georgia,GA-500,Atlanta,13121,Fulton County,2020,1077402,520579,556823,486057,479663,2972,84277,455,23978,999761,77641
449,Georgia,GA-500,Atlanta,13121,Fulton County,2021,1065334,516655,548679,477965,476325,2963,83471,386,24224,987601,77733
104,Texas,TX-700,"Houston, Pasadena, Conroe/Harris, Ft. Bend, Montgomery",48201,Harris County,2007,3909239,1957744,1951495,2866754,741822,25431,220330,5848,49054,2409856,1499383
105,Texas,TX-700,"Houston, Pasadena, Conroe/Harris, Ft. Bend, Montgomery",48201,Harris County,2008,3980602,1995771,1984831,2917566,751320,26824,226864,6296,51732,2423620,1556982
106,Texas,TX-700,"Houston, Pasadena, Conroe/Harris, Ft. Bend, Montgomery",48201,Harris County,2009,4070989,2043035,2027954,2981004,765596,28302,234602,6761,54724,2451563,1619426
107,Texas,TX-700,"Houston, Pasadena, Conroe/Harris, Ft. Bend, Montgomery",48201,Harris County,2010,4092459,2037405,2055054,2918354,798077,46842,261637,5498,62051,2420919,1671540
384,Texas,TX-700,"Houston, Pasadena, Conroe/Harris, Ft. Bend, Montgomery",48201,Harris County,2011,4179279,2077976,2101303,2972044,815693,47297,273480,5312,65453,2458155,1721124
385,Texas,TX-700,"Houston, Pasadena, Conroe/Harris, Ft. Bend, Montgomery",48201,Harris County,2012,4262549,2119533,2143016,3020609,834000,47862,285669,5309,69100,2500058,1762491
386,Texas,TX-700,"Houston, Pasadena, Conroe/Harris, Ft. Bend, Montgomery",48201,Harris County,2013,4352419,2164647,2187772,3073490,852247,48688,299812,5397,72785,2544470,1807949
387,Texas,TX-700,"Houston, Pasadena, Conroe/Harris, Ft. Bend, Montgomery",48201,Harris County,2014,4454951,2215946,2239005,3132680,874828,49306,315522,5460,77155,2598638,1856313
388,Texas,TX-700,"Houston, Pasadena, Conroe/Harris, Ft. Bend, Montgomery",48201,Harris County,2015,4556559,2267146,2289413,3191154,898170,50083,330087,5500,81565,2646401,1910158
389,Texas,TX-700,"Houston, Pasadena, Conroe/Harris, Ft. Bend, Montgomery",48201,Harris County,2016,4622836,2299012,2323824,3227742,914847,50566,339660,5507,84514,2667617,1955219
390,Texas,TX-700,"Houston, Pasadena, Conroe/Harris, Ft. Bend, Montgomery",48201,Harris County,2017,4655798,2313360,2342438,3241824,926413,50871,344750,5458,86482,2667632,1988166
391,Texas,TX-700,"Houston, Pasadena, Conroe/Harris, Ft. Bend, Montgomery",48201,Harris County,2018,4676913,2321982,2354931,3246255,938133,51131,347189,5485,88720,2661793,2015120
392,Texas,TX-700,"Houston, Pasadena, Conroe/Harris, Ft. Bend, Montgomery",48201,Harris County,2019,4709243,2336350,2372893,3261618,948407,51788,351205,5557,90668,2661756,2047487
393,Texas,TX-700,"Houston, Pasadena, Conroe/Harris, Ft. Bend, Montgomery",48201,Harris County,2020,4738253,2349869,2388384,3274049,959264,52703,353338,5552,93347,2661123,2077130
460,Texas,TX-700,"Houston, Pasadena, Conroe/Harris, Ft. Bend, Montgomery",48201,Harris County,2021,4728030,2354169,2373861,3261327,962028,53319,350720,5511,95125,2630428,2097602
56,Florida,FL-501,Tampa/Hillsborough County,12057,Hillsborough County,2007,1169910,576670,593240,912143,193763,6472,36544,1545,19443,908036,261874
57,Florida,FL-501,Tampa/Hillsborough County,12057,Hillsborough County,2008,1180118,581866,598252,916305,197293,6706,37982,1590,20242,909824,270294
58,Florida,FL-501,Tampa/Hillsborough County,12057,Hillsborough County,2009,1195317,589575,605742,924437,202033,6930,39205,1662,21050,915772,279545
59,Florida,FL-501,Tampa/Hillsborough County,12057,Hillsborough County,2010,1229226,599084,630142,937745,212420,6008,43697,1475,27881,922591,306635
264,Florida,FL-501,Tampa/Hillsborough County,12057,Hillsborough County,2011,1255639,614669,640970,952277,220106,6479,45915,1498,29364,937554,318085
265,Florida,FL-501,Tampa/Hillsborough County,12057,Hillsborough County,2012,1279861,624951,654910,970100,222805,6602,48151,1608,30595,949345,330516
266,Florida,FL-501,Tampa/Hillsborough County,12057,Hillsborough County,2013,1304474,635991,668483,985672,227416,6678,50867,1730,32111,961088,343386
267,Florida,FL-501,Tampa/Hillsborough County,12057,Hillsborough County,2014,1332742,649726,683016,1003712,233865,6896,53012,1805,33452,975649,357093
268,Florida,FL-501,Tampa/Hillsborough County,12057,Hillsborough County,2015,1364645,665954,698691,1024082,240672,7047,55504,1851,35489,991569,373076
269,Florida,FL-501,Tampa/Hillsborough County,12057,Hillsborough County,2016,1398093,682697,715396,1045361,247562,7222,58667,1893,37388,1006912,391181
270,Florida,FL-501,Tampa/Hillsborough County,12057,Hillsborough County,2017,1428960,698819,730141,1063927,254497,7496,61931,1885,39224,1020070,408890
271,Florida,FL-501,Tampa/Hillsborough County,12057,Hillsborough County,2018,1455351,712206,743145,1079685,260497,7671,64629,1909,40960,1030300,425051
272,Florida,FL-501,Tampa/Hillsborough County,12057,Hillsborough County,2019,1476431,722696,753735,1090460,266794,7836,66784,1974,42583,1040438,435993
273,Florida,FL-501,Tampa/Hillsborough County,12057,Hillsborough County,2020,1497957,733475,764482,1101802,273549,8049,68404,2038,44115,1049421,448536
448,Florida,FL-501,Tampa/Hillsborough County,12057,Hillsborough County,2021,1478194,727733,750461,1083063,272285,8052,67802,2082,44910,1030273,447921
48,Colorado,CO-503,Metropolitan Denver,8059,Jefferson County,2007,528396,262971,265425,491565,8031,5217,13988,633,8962,456397,71999
49,Colorado,CO-503,Metropolitan Denver,8059,Jefferson County,2008,533295,265538,267757,495173,8448,5357,14345,663,9309,458535,74760
50,Colorado,CO-503,Metropolitan Denver,8059,Jefferson County,2009,536922,267409,269513,497652,8768,5450,14787,693,9572,460674,76248
51,Colorado,CO-503,Metropolitan Denver,8059,Jefferson County,2010,534543,265317,269226,495530,6265,6217,14507,586,11438,458098,76445
244,Colorado,CO-503,Metropolitan Denver,8059,Jefferson County,2011,540582,268344,272238,500405,6447,6367,14897,647,11819,461358,79224
245,Colorado,CO-503,Metropolitan Denver,8059,Jefferson County,2012,546736,271489,275247,505314,6659,6530,15293,652,12288,465189,81547
246,Colorado,CO-503,Metropolitan Denver,8059,Jefferson County,2013,552242,274264,277978,510295,6777,6544,15383,668,12575,469201,83041
247,Colorado,CO-503,Metropolitan Denver,8059,Jefferson County,2014,559099,277790,281309,515966,6947,6733,15719,676,13058,474980,84119
248,Colorado,CO-503,Metropolitan Denver,8059,Jefferson County,2015,565240,281060,284180,521008,7073,6763,16289,694,13413,479708,85532
249,Colorado,CO-503,Metropolitan Denver,8059,Jefferson County,2016,571823,284532,287291,526261,7498,6869,16730,703,13762,484593,87230
250,Colorado,CO-503,Metropolitan Denver,8059,Jefferson County,2017,576041,287262,288779,529189,7893,6906,17092,739,14222,487206,88835
251,Colorado,CO-503,Metropolitan Denver,8059,Jefferson County,2018,580027,289096,290931,531579,8334,7033,17605,713,14763,490198,89829
252,Colorado,CO-503,Metropolitan Denver,8059,Jefferson County,2019,582800,290981,291819,532941,8641,7204,18042,755,15217,491871,90929
253,Colorado,CO-503,Metropolitan Denver,8059,Jefferson County,2020,583283,291446,291837,532304,8962,7247,18467,787,15516,491911,91372
446,Colorado,CO-503,Metropolitan Denver,8059,Jefferson County,2021,579581,291593,287988,528212,9207,7159,18484,786,15733,487482,92099
120,Washington,WA-500,Seattle/King,53033,King County,2007,1857506,926286,931220,1399696,116390,18255,248952,11879,62334,1717987,139519
121,Washington,WA-500,Seattle/King,53033,King County,2008,1884242,941727,942515,1411320,120326,18694,257464,12275,64163,1736780,147462
122,Washington,WA-500,Seattle/King,53033,King County,2009,1916441,958922,957519,1426855,124612,18761,267420,12764,66029,1761149,155292
123,Washington,WA-500,Seattle/King,53033,King County,2010,1931249,962090,969159,1396927,124232,20237,286648,15317,87888,1758871,172378
424,Washington,WA-500,Seattle/King,53033,King County,2011,1974499,982634,991865,1414377,128651,20733,302723,15657,92358,1796716,177783
425,Washington,WA-500,Seattle/King,53033,King County,2012,2011708,1001535,1010173,1429553,132606,21204,316319,16068,95958,1828765,182943
426,Washington,WA-500,Seattle/King,53033,King County,2013,2047967,1021099,1026868,1443868,135801,21765,330226,16641,99666,1858948,189019
427,Washington,WA-500,Seattle/King,53033,King County,2014,2086174,1041152,1045022,1456473,138729,22078,348382,17021,103491,1891667,194507
428,Washington,WA-500,Seattle/King,53033,King County,2015,2127372,1063251,1064121,1470752,142289,22249,367220,17507,107355,1927375,199997
429,Washington,WA-500,Seattle/King,53033,King County,2016,2167863,1085496,1082367,1483394,145643,22452,386670,18069,111635,1960548,207315
430,Washington,WA-500,Seattle/King,53033,King County,2017,2205001,1105832,1099169,1489973,149967,22704,408614,18305,115438,1991092,213909
431,Washington,WA-500,Seattle/King,53033,King County,2018,2228488,1119197,1109291,1486593,153905,22665,428450,18389,118486,2009856,218632
432,Washington,WA-500,Seattle/King,53033,King County,2019,2249653,1131500,1118153,1483604,157816,22776,445799,18559,121099,2025362,224291
433,Washington,WA-500,Seattle/King,53033,King County,2020,2274315,1145520,1128795,1482855,161627,22837,464002,18900,124094,2044645,229670
464,Washington,WA-500,Seattle/King,53033,King County,2021,2252305,1141102,1111203,1450858,162529,23024,471332,18840,125722,2020561,231744
84,New York,NY-600,New York City,36047,Kings County,2007,2539206,1199194,1340012,1308311,943668,12672,233425,3661,37469,2043433,495773
85,New York,NY-600,New York City,36047,Kings County,2008,2549941,1205844,1344097,1315724,940407,12718,238950,3730,38412,2052374,497567
86,New York,NY-600,New York City,36047,Kings County,2009,2567098,1215532,1351566,1324274,942470,13011,244079,3850,39414,2064552,502546
87,New York,NY-600,New York City,36047,Kings County,2010,2504700,1181378,1323322,1240321,914067,26144,269251,3423,51494,2008415,496285
334,New York,NY-600,New York City,36047,Kings County,2011,2540918,1199951,1340967,1256619,918404,26116,282106,3382,54291,2039522,501396
335,New York,NY-600,New York City,36047,Kings County,2012,2568538,1214743,1353795,1270237,918890,26332,293232,3377,56470,2065666,502872
336,New York,NY-600,New York City,36047,Kings County,2013,2587759,1224171,1363588,1279267,917256,26304,302855,3296,58781,2084848,502911
337,New York,NY-600,New York City,36047,Kings County,2014,2601527,1231191,1370336,1286354,913034,26197,312112,3262,60568,2099588,501939
338,New York,NY-600,New York City,36047,Kings County,2015,2608797,1235255,1373542,1290443,906161,25880,320455,3188,62670,2109274,499523
339,New York,NY-600,New York City,36047,Kings County,2016,2608146,1236161,1371985,1290760,896486,25638,327424,3132,64706,2111808,496338
340,New York,NY-600,New York City,36047,Kings County,2017,2594357,1229691,1364666,1285086,885011,25092,329794,3106,66268,2103450,490907
341,New York,NY-600,New York City,36047,Kings County,2018,2580088,1222935,1357153,1282337,872608,24772,329531,3063,67777,2093622,486466
342,New York,NY-600,New York City,36047,Kings County,2019,2562329,1213715,1348614,1274925,861925,24541,328643,3021,69274,2081048,481281
343,New York,NY-600,New York City,36047,Kings County,2020,2538934,1202138,1336796,1263004,850352,24213,327999,2902,70464,2062566,476368
455,New York,NY-600,New York City,36047,Kings County,2021,2641052,1257617,1383435,1317619,878809,25380,341891,2896,74457,2144255,496797
4,California,CA-600,Los Angeles City & County,6037,Los Angeles County,2007,9734701,4824222,4910479,7206818,924968,95152,1292990,33477,181296,5142567,4592134
5,California,CA-600,Los Angeles City & County,6037,Los Angeles County,2008,9779254,4848351,4930903,7239811,919233,95559,1307086,33725,183840,5127538,4651716
6,California,CA-600,Los Angeles City & County,6037,Los Angeles County,2009,9848011,4885793,4962218,7291271,919874,96946,1319195,33799,186926,5118618,4729393
7,California,CA-600,Los Angeles City & County,6037,Los Angeles County,2010,9818605,4839654,4978951,7056710,920648,146005,1393578,36443,265221,5130716,4687889
134,California,CA-600,Los Angeles City & County,6037,Los Angeles County,2011,9873700,4863389,5010311,7081018,920197,146065,1416260,36619,273541,5140614,4733086
135,California,CA-600,Los Angeles City & County,6037,Los Angeles County,2012,9931394,4891478,5039916,7105521,922746,146790,1438650,36904,280783,5162623,4768771
136,California,CA-600,Los Angeles City & County,6037,Los Angeles County,2013,9987189,4919940,5067249,7125720,924836,146864,1464161,37104,288504,5186468,4800721
137,California,CA-600,Los Angeles City & County,6037,Los Angeles County,2014,10033449,4943255,5090194,7139021,924099,146972,1490142,37140,296075,5206532,4826917
138,California,CA-600,Los Angeles City & County,6037,Los Angeles County,2015,10077263,4965853,5111410,7149831,921256,146875,1518807,37245,303249,5226971,4850292
139,California,CA-600,Los Angeles City & County,6037,Los Angeles County,2016,10094865,4975091,5119774,7147727,916573,146823,1537542,37245,308955,5228937,4865928
140,California,CA-600,Los Angeles City & County,6037,Los Angeles County,2017,10092365,4975410,5116955,7127094,912145,146663,1555006,36979,314478,5224186,4868179
141,California,CA-600,Los Angeles City & County,6037,Los Angeles County,2018,10061533,4960497,5101036,7092590,906318,145912,1560645,36752,319316,5202600,4858933
142,California,CA-600,Los Angeles City & County,6037,Los Angeles County,2019,10011602,4935416,5076186,7044004,900628,146210,1561422,36698,322640,5170149,4841453
143,California,CA-600,Los Angeles City & County,6037,Los Angeles County,2020,9943046,4901414,5041632,6981210,895268,146590,1558134,36483,325361,5120820,4822226
435,California,CA-600,Los Angeles City & County,6037,Los Angeles County,2021,9829544,4870802,4958742,6901193,881356,146475,1538016,36203,326301,5004555,4824989
0,Arizona,AZ-502,"Phoenix,Mesa/Maricopa",4013,Maricopa County,2007,3872962,1952456,1920506,3402742,189236,87101,116484,8984,68415,2684004,1188958
1,Arizona,AZ-502,"Phoenix,Mesa/Maricopa",4013,Maricopa County,2008,3958263,1996950,1961313,3465898,199834,88851,122501,9364,71815,2718008,1240255
2,Arizona,AZ-502,"Phoenix,Mesa/Maricopa",4013,Maricopa County,2009,4023132,2030550,1992582,3513005,209298,89262,127259,9675,74633,2742486,1280646
3,Arizona,AZ-502,"Phoenix,Mesa/Maricopa",4013,Maricopa County,2010,3817117,1888465,1928652,3268366,205732,99663,140285,10115,92956,2688376,1128741
124,Arizona,AZ-502,"Phoenix,Mesa/Maricopa",4013,Maricopa County,2011,3875371,1915659,1959712,3303462,212348,101821,149099,10314,98327,2724688,1150683
125,Arizona,AZ-502,"Phoenix,Mesa/Maricopa",4013,Maricopa County,2012,3948165,1952336,1995829,3351785,220472,105117,156791,10637,103363,2769106,1179059
126,Arizona,AZ-502,"Phoenix,Mesa/Maricopa",4013,Maricopa County,2013,4018657,1987399,2031258,3397404,228289,108668,164859,10929,108508,2811179,1207478
127,Arizona,AZ-502,"Phoenix,Mesa/Maricopa",4013,Maricopa County,2014,4094842,2025225,2069617,3447471,236428,112536,173669,11236,113502,2856067,1238775
128,Arizona,AZ-502,"Phoenix,Mesa/Maricopa",4013,Maricopa County,2015,4174423,2064762,2109661,3500088,246967,115750,181489,11526,118603,2901610,1272813
129,Arizona,AZ-502,"Phoenix,Mesa/Maricopa",4013,Maricopa County,2016,4258019,2105955,2152064,3553696,258282,118860,191248,11887,124046,2950840,1307179
130,Arizona,AZ-502,"Phoenix,Mesa/Maricopa",4013,Maricopa County,2017,4329227,2141309,2187918,3600583,268026,121644,197992,12267,128715,2989049,1340178
131,Arizona,AZ-502,"Phoenix,Mesa/Maricopa",4013,Maricopa County,2018,4405306,2178372,2226934,3652219,278644,124643,203002,12601,134197,3032543,1372763
132,Arizona,AZ-502,"Phoenix,Mesa/Maricopa",4013,Maricopa County,2019,4492261,2220757,2271504,3710128,289834,128007,210900,13072,140320,3084002,1408259
133,Arizona,AZ-502,"Phoenix,Mesa/Maricopa",4013,Maricopa County,2020,4579081,2263436,2315645,3769382,300001,131225,218410,13547,146516,3135903,1443178
434,Arizona,AZ-502,"Phoenix,Mesa/Maricopa",4013,Maricopa County,2021,4496588,2235024,2261564,3686444,300365,132593,216046,13419,147721,3059887,1436701
108,Texas,TX-700,"Houston, Pasadena, Conroe/Harris, Ft. Bend, Montgomery",48339,Montgomery County,2007,412630,205154,207476,377827,19866,2328,7371,179,5059,341111,71519
109,Texas,TX-700,"Houston, Pasadena, Conroe/Harris, Ft. Bend, Montgomery",48339,Montgomery County,2008,431238,214588,216650,393422,21523,2515,8105,186,5487,353228,78010
110,Texas,TX-700,"Houston, Pasadena, Conroe/Harris, Ft. Bend, Montgomery",48339,Montgomery County,2009,447718,222944,224774,407276,22880,2677,8737,193,5955,363642,84076
111,Texas,TX-700,"Houston, Pasadena, Conroe/Harris, Ft. Bend, Montgomery",48339,Montgomery County,2010,455746,225911,229835,413629,20104,4697,10008,455,6853,361048,94698
394,Texas,TX-700,"Houston, Pasadena, Conroe/Harris, Ft. Bend, Montgomery",48339,Montgomery County,2011,471456,233458,237998,426987,20896,4794,10915,511,7353,371369,100087
395,Texas,TX-700,"Houston, Pasadena, Conroe/Harris, Ft. Bend, Montgomery",48339,Montgomery County,2012,484627,240030,244597,438125,21790,4834,11625,547,7706,379627,105000
396,Texas,TX-700,"Houston, Pasadena, Conroe/Harris, Ft. Bend, Montgomery",48339,Montgomery County,2013,498488,246905,251583,449512,22773,4919,12582,581,8121,389101,109387
397,Texas,TX-700,"Houston, Pasadena, Conroe/Harris, Ft. Bend, Montgomery",48339,Montgomery County,2014,517262,256339,260923,464925,24152,5010,13836,579,8760,401708,115554
398,Texas,TX-700,"Houston, Pasadena, Conroe/Harris, Ft. Bend, Montgomery",48339,Montgomery County,2015,535913,265562,270351,479893,25848,5208,14972,620,9372,412997,122916
399,Texas,TX-700,"Houston, Pasadena, Conroe/Harris, Ft. Bend, Montgomery",48339,Montgomery County,2016,555338,275202,280136,494871,28235,5412,16269,610,9941,425060,130278
400,Texas,TX-700,"Houston, Pasadena, Conroe/Harris, Ft. Bend, Montgomery",48339,Montgomery County,2017,571542,283044,288498,506497,30569,5570,17725,636,10545,434115,137427
401,Texas,TX-700,"Houston, Pasadena, Conroe/Harris, Ft. Bend, Montgomery",48339,Montgomery County,2018,590127,292012,298115,520220,33410,5815,18907,643,11132,445305,144822
402,Texas,TX-700,"Houston, Pasadena, Conroe/Harris, Ft. Bend, Montgomery",48339,Montgomery County,2019,607583,300569,307014,533196,35836,5956,20151,711,11733,455594,151989
403,Texas,TX-700,"Houston, Pasadena, Conroe/Harris, Ft. Bend, Montgomery",48339,Montgomery County,2020,626351,309818,316533,546739,38755,6162,21555,741,12399,466111,160240
461,Texas,TX-700,"Houston, Pasadena, Conroe/Harris, Ft. Bend, Montgomery",48339,Montgomery County,2021,648886,322459,326427,562434,42920,6484,22863,843,13342,477790,171096
88,New York,NY-600,New York City,36061,New York County,2007,1625251,773502,851749,1100912,305751,10004,171342,2236,35006,1229217,396034
89,New York,NY-600,New York City,36061,New York County,2008,1631599,776919,854680,1106934,301826,10076,174717,2234,35812,1237921,393678
90,New York,NY-600,New York City,36061,New York County,2009,1629054,775857,853197,1106065,297440,10011,176984,2231,36323,1241376,387678
91,New York,NY-600,New York City,36061,New York County,2010,1585873,744441,841432,1039141,294120,19240,184345,2645,46382,1182296,403577
344,New York,NY-600,New York City,36061,New York County,2011,1608717,756662,852055,1050496,297626,19470,190390,2758,47977,1197329,411388
345,New York,NY-600,New York City,36061,New York County,2012,1624573,765853,858720,1058695,298893,19646,194768,2854,49717,1206621,417952
346,New York,NY-600,New York City,36061,New York County,2013,1628379,768000,860379,1059821,299022,19919,195998,2905,50714,1207759,420620
347,New York,NY-600,New York City,36061,New York County,2014,1631733,769928,861805,1060049,297831,19955,199165,2981,51752,1209657,422076
348,New York,NY-600,New York City,36061,New York County,2015,1637327,774033,863294,1059737,297889,20146,203596,2939,53020,1213175,424152
349,New York,NY-600,New York City,36061,New York County,2016,1636721,774410,862311,1056974,296396,19966,206491,2942,53952,1213274,423447
350,New York,NY-600,New York City,36061,New York County,2017,1632337,772978,859359,1052674,293833,19865,208350,2981,54634,1211654,420683
351,New York,NY-600,New York City,36061,New York County,2018,1632393,773085,859308,1052541,292415,19859,209207,3010,55361,1213270,419123
352,New York,NY-600,New York City,36061,New York County,2019,1632326,773220,859106,1052039,290443,19742,210971,3018,56113,1216201,416125
353,New York,NY-600,New York City,36061,New York County,2020,1611989,762760,849229,1034917,288483,19659,209878,2954,56098,1199154,412835
456,New York,NY-600,New York City,36061,New York County,2021,1576876,750185,826691,1001547,291068,19986,204789,3079,56407,1161174,415702
100,Pennsylvania,PA-500,Philadelphia,42101,Philadelphia County,2007,1530031,715302,814729,739317,675846,6536,85131,1860,21341,1360799,169232
101,Pennsylvania,PA-500,Philadelphia,42101,Philadelphia County,2008,1540351,720459,819892,745855,677043,6775,86821,1907,21950,1365048,175303
102,Pennsylvania,PA-500,Philadelphia,42101,Philadelphia County,2009,1547297,724551,822746,751673,675987,7024,88321,1947,22345,1366005,181292
103,Pennsylvania,PA-500,Philadelphia,42101,Philadelphia County,2010,1526006,719813,806193,696866,682166,12127,99418,1999,33430,1338395,187611
374,Pennsylvania,PA-500,Philadelphia,42101,Philadelphia County,2011,1540615,727164,813451,698736,688754,12426,103623,2015,35061,1344403,196212
375,Pennsylvania,PA-500,Philadelphia,42101,Philadelphia County,2012,1552087,733021,819066,701539,693080,12611,106394,2087,36376,1348770,203317
376,Pennsylvania,PA-500,Philadelphia,42101,Philadelphia County,2013,1558713,736718,821995,700806,695636,12973,109496,2203,37599,1349628,209085
377,Pennsylvania,PA-500,Philadelphia,42101,Philadelphia County,2014,1565949,740475,825474,701946,697146,13201,112348,2308,39000,1350188,215761
378,Pennsylvania,PA-500,Philadelphia,42101,Philadelphia County,2015,1571679,743429,828250,702301,698440,13515,114823,2447,40153,1350145,221534
379,Pennsylvania,PA-500,Philadelphia,42101,Philadelphia County,2016,1576604,746448,830156,703709,698119,13653,117328,2541,41254,1349476,227128
380,Pennsylvania,PA-500,Philadelphia,42101,Philadelphia County,2017,1581699,748615,833084,705516,697220,13854,120125,2616,42368,1348262,233437
381,Pennsylvania,PA-500,Philadelphia,42101,Philadelphia County,2018,1586422,751212,835210,706957,696392,14138,122553,2762,43620,1345658,240764
382,Pennsylvania,PA-500,Philadelphia,42101,Philadelphia County,2019,1584439,750076,834363,706202,692815,14268,123862,2834,44458,1341058,243381
383,Pennsylvania,PA-500,Philadelphia,42101,Philadelphia County,2020,1578487,747016,831471,704367,686918,14405,124711,2834,45252,1332640,245847
459,Pennsylvania,PA-500,Philadelphia,42101,Philadelphia County,2021,1576251,749447,826804,699767,686917,14681,125715,2760,46411,1325766,250485
92,New York,NY-600,New York City,36081,Queens County,2007,2277779,1105499,1172280,1260203,463403,15948,491045,3410,43770,1680942,596837
93,New York,NY-600,New York City,36081,Queens County,2008,2288574,1112378,1176196,1262558,460661,16068,501139,3526,44622,1681945,606629
94,New York,NY-600,New York City,36081,Queens County,2009,2306712,1122781,1183931,1268280,461235,16388,511513,3673,45623,1686507,620205
95,New York,NY-600,New York City,36081,Queens County,2010,2230722,1079803,1150919,1130036,469784,29628,539400,4725,57149,1616972,613750
354,New York,NY-600,New York City,36081,Queens County,2011,2255261,1092024,1163237,1131979,474744,30067,554674,4706,59091,1631335,623926
355,New York,NY-600,New York City,36081,Queens County,2012,2271920,1100089,1171831,1132815,475820,31031,566937,4764,60553,1640936,630984
356,New York,NY-600,New York City,36081,Queens County,2013,2286788,1108133,1178655,1131924,478167,31265,578425,4933,62074,1650345,636443
357,New York,NY-600,New York City,36081,Queens County,2014,2298234,1113851,1184383,1129385,477987,31433,590571,4990,63868,1659039,639195
358,New York,NY-600,New York City,36081,Queens County,2015,2305252,1117874,1187378,1123341,478245,31440,601986,5077,65163,1664769,640483
359,New York,NY-600,New York City,36081,Queens County,2016,2306249,1118762,1187487,1114872,476930,31538,611411,5167,66331,1666634,639615
360,New York,NY-600,New York City,36081,Queens County,2017,2295226,1113386,1181840,1101600,474407,31375,615852,5266,66726,1658674,636552
361,New York,NY-600,New York City,36081,Queens County,2018,2275286,1104510,1170776,1086006,470127,31143,615473,5337,67200,1642933,632353
362,New York,NY-600,New York City,36081,Queens County,2019,2253942,1094325,1159617,1070359,466075,30759,614097,5302,67350,1626022,627920
363,New York,NY-600,New York City,36081,Queens County,2020,2225821,1080522,1145299,1051097,461357,30414,610301,5308,67344,1603890,621931
457,New York,NY-600,New York City,36081,Queens County,2021,2331143,1139130,1192013,1102098,481931,32525,637099,5610,71880,1675724,655419
96,New York,NY-600,New York City,36085,Richmond County,2007,482854,235224,247630,387261,51814,1535,34977,315,6952,410401,72453
97,New York,NY-600,New York City,36085,Richmond County,2008,487365,237752,249613,389155,53020,1567,36030,320,7273,412017,75348
98,New York,NY-600,New York City,36085,Richmond County,2009,491730,240090,251640,391038,54389,1613,36779,326,7585,413383,78347
99,New York,NY-600,New York City,36085,Richmond County,2010,468730,227289,241441,366865,54132,3018,36238,444,8033,387679,81051
364,New York,NY-600,New York City,36085,Richmond County,2011,471014,228105,242909,367122,55080,3014,36975,465,8358,389109,81905
365,New York,NY-600,New York City,36085,Richmond County,2012,470597,227537,243060,366715,54555,2946,37315,462,8604,388263,82334
366,New York,NY-600,New York City,36085,Richmond County,2013,471783,228253,243530,366696,54954,2958,37726,471,8978,388276,83507
367,New York,NY-600,New York City,36085,Richmond County,2014,471899,228279,243620,365465,55255,2974,38589,478,9138,387613,84286
368,New York,NY-600,New York City,36085,Richmond County,2015,472301,228536,243765,364467,55396,3025,39560,491,9362,386916,85385
369,New York,NY-600,New York City,36085,Richmond County,2016,474160,229634,244526,363379,56034,3148,41470,501,9628,387589,86571
370,New York,NY-600,New York City,36085,Richmond County,2017,475819,230665,245154,361436,56007,3174,44772,510,9920,388346,87473
371,New York,NY-600,New York City,36085,Richmond County,2018,476531,231077,245454,358008,55782,3173,48943,530,10095,388632,87899
372,New York,NY-600,New York City,36085,Richmond County,2019,476141,231301,244840,353578,55660,3258,52790,533,10322,388174,87967
373,New York,NY-600,New York City,36085,Richmond County,2020,475327,230971,244356,349060,55693,3373,55975,586,10640,386574,88753
458,New York,NY-600,New York City,36085,Richmond County,2021,493494,241523,251971,360289,57244,3611,60603,573,11174,401414,92080
16,California,CA-609,San Bernardino City & County,6071,San Bernardino County,2007,1992989,1000936,992053,1602303,188216,28980,116250,7719,49521,1058929,934060
17,California,CA-609,San Bernardino City & County,6071,San Bernardino County,2008,2004914,1006981,997933,1609572,189155,29369,118430,7795,50593,1050948,953966
18,California,CA-609,San Bernardino City & County,6071,San Bernardino County,2009,2017673,1013535,1004138,1616609,190825,29787,120571,7990,51891,1047643,970030
19,California,CA-609,San Bernardino City & County,6071,San Bernardino County,2010,2035210,1011507,1023703,1585604,196754,41001,137586,9113,65152,1034065,1001145
164,California,CA-609,San Bernardino City & County,6071,San Bernardino County,2011,2060596,1024113,1036483,1601249,198977,41652,142164,9245,67309,1031170,1029426
165,California,CA-609,San Bernardino City & County,6071,San Bernardino County,2012,2073088,1031405,1041683,1609437,199713,41776,144115,9437,68610,1025831,1047257
166,California,CA-609,San Bernardino City & County,6071,San Bernardino County,2013,2082101,1035311,1046790,1613303,199421,42270,147268,9513,70326,1019022,1063079
167,California,CA-609,San Bernardino City & County,6071,San Bernardino County,2014,2098346,1044094,1054252,1621862,200969,42727,151294,9629,71865,1015963,1082383
168,California,CA-609,San Bernardino City & County,6071,San Bernardino County,2015,2114352,1052246,1062106,1629743,201939,43245,156130,9796,73499,1012126,1102226
169,California,CA-609,San Bernardino City & County,6071,San Bernardino County,2016,2130726,1060292,1070434,1637763,202604,44037,161074,10016,75232,1008452,1122274
170,California,CA-609,San Bernardino City & County,6071,San Bernardino County,2017,2149847,1070072,1079775,1646404,203818,44771,167278,10388,77188,1005987,1143860
171,California,CA-609,San Bernardino City & County,6071,San Bernardino County,2018,2165627,1078174,1087453,1652360,205121,45458,173334,10544,78810,1001229,1164398
172,California,CA-609,San Bernardino City & County,6071,San Bernardino County,2019,2177279,1083953,1093326,1656335,205695,46214,178370,10681,79984,994240,1183039
173,California,CA-609,San Bernardino City & County,6071,San Bernardino County,2020,2189183,1090578,1098605,1659869,206682,47038,183209,10879,81506,987563,1201620
438,California,CA-609,San Bernardino City & County,6071,San Bernardino County,2021,2194710,1098508,1096202,1659921,206374,47910,187149,10992,82364,970025,1224685
8,California,CA-601,San Diego City and County,6073,San Diego County,2007,2975656,1490385,1485271,2372263,165778,30356,302817,16177,88265,2073228,902428
9,California,CA-601,San Diego City and County,6073,San Diego County,2008,3019274,1515090,1504184,2401836,168184,31114,310510,16417,91213,2088556,930718
10,California,CA-601,San Diego City and County,6073,San Diego County,2009,3053793,1532109,1521684,2424183,169851,31825,317495,16533,93906,2096547,957246
11,California,CA-601,San Diego City and County,6073,San Diego County,2010,3095313,1553679,1541634,2389730,172623,41343,349661,18405,123551,2103965,991348
144,California,CA-601,San Diego City and County,6073,San Diego County,2011,3137236,1573485,1563751,2414065,174309,41460,360129,18649,128624,2121963,1015273
145,California,CA-601,San Diego City and County,6073,San Diego County,2012,3175148,1595040,1580108,2436763,176681,41909,368407,18747,132641,2141441,1033707
146,California,CA-601,San Diego City and County,6073,San Diego County,2013,3210788,1612489,1598299,2456428,177918,42296,378194,19200,136752,2158136,1052652
147,California,CA-601,San Diego City and County,6073,San Diego County,2014,3249307,1633854,1615453,2477623,179750,42918,388566,19364,141086,2178056,1071251
148,California,CA-601,San Diego City and County,6073,San Diego County,2015,3280825,1651891,1628934,2493142,181481,43338,398000,19547,145317,2192287,1088538
149,California,CA-601,San Diego City and County,6073,San Diego County,2016,3305462,1664812,1640650,2504913,182866,43587,405591,19653,148852,2199946,1105516
150,California,CA-601,San Diego City and County,6073,San Diego County,2017,3319019,1671454,1647565,2507045,183879,43810,412297,19758,152230,2201080,1117939
151,California,CA-601,San Diego City and County,6073,San Diego County,2018,3332483,1679402,1653081,2509352,184958,43989,418513,19867,155804,2204476,1128007
152,California,CA-601,San Diego City and County,6073,San Diego County,2019,3330459,1677056,1653403,2500540,184615,44335,422456,19907,158606,2194969,1135490
153,California,CA-601,San Diego City and County,6073,San Diego County,2020,3332427,1679841,1652586,2493970,184912,44649,427698,19979,161219,2188051,1144376
436,California,CA-601,San Diego City and County,6073,San Diego County,2021,3286069,1664962,1621107,2452765,183071,44454,423890,19816,162073,2140886,1145183
20,California,CA-501,San Francisco,6075,San Francisco County,2007,799185,405953,393232,459394,55636,4320,253628,3964,22243,686357,112828
21,California,CA-501,San Francisco,6075,San Francisco County,2008,808001,410317,397684,466628,54807,4427,255274,3956,22909,693145,114856
22,California,CA-501,San Francisco,6075,San Francisco County,2009,815358,414059,401299,473081,54598,4573,255681,4010,23415,697866,117492
23,California,CA-501,San Francisco,6075,San Francisco County,2010,805235,408462,396773,439461,51555,6976,271876,3778,31589,683461,121774
174,California,CA-501,San Francisco,6075,San Francisco County,2011,815694,413972,401722,444016,50460,6987,277592,3854,32785,691664,124030
175,California,CA-501,San Francisco,6075,San Francisco County,2012,828963,421351,407612,450976,49806,7003,283417,3873,33888,702373,126590
176,California,CA-501,San Francisco,6075,San Francisco County,2013,839695,427517,412178,455071,49566,6945,289271,3878,34964,711522,128173
177,California,CA-501,San Francisco,6075,San Francisco County,2014,850918,433889,417029,459449,49126,6821,295514,3928,36080,721422,129496
178,California,CA-501,San Francisco,6075,San Francisco County,2015,863237,440483,422754,464234,48854,6773,302252,3893,37231,732114,131123
179,California,CA-501,San Francisco,6075,San Francisco County,2016,871343,444435,426908,465996,48653,6653,307834,3893,38314,739017,132326
180,California,CA-501,San Francisco,6075,San Francisco County,2017,877471,447894,429577,466216,48818,6660,312407,3963,39407,744310,133161
181,California,CA-501,San Francisco,6075,San Francisco County,2018,879676,448829,430847,465246,48759,6569,314701,3972,40429,746107,133569
182,California,CA-501,San Francisco,6075,San Francisco County,2019,878826,448152,430674,461967,48579,6526,316685,4004,41065,745518,133308
183,California,CA-501,San Francisco,6075,San Francisco County,2020,866606,441638,424968,451167,48069,6357,316220,3942,40851,734641,131965
439,California,CA-501,San Francisco,6075,San Francisco County,2021,815201,416907,398294,416171,46164,6221,303648,3817,39180,687171,128030
12,California,CA-500,San Jose/Santa Clara City & County,6085,Santa Clara County,2007,1723927,879511,844416,1077601,49456,13056,530966,7427,45421,1281872,442055
13,California,CA-500,San Jose/Santa Clara City & County,6085,Santa Clara County,2008,1755849,896298,859551,1088330,50257,13403,549430,7534,46895,1300464,455385
14,California,CA-500,San Jose/Santa Clara City & County,6085,Santa Clara County,2009,1784642,911518,873124,1098769,51073,13826,565222,7670,48082,1315678,468964
15,California,CA-500,San Jose/Santa Clara City & County,6085,Santa Clara County,2010,1781642,893851,887791,1046294,51766,24956,582020,8709,67897,1302432,479210
154,California,CA-500,San Jose/Santa Clara City & County,6085,Santa Clara County,2011,1811891,909115,902776,1050830,52247,24725,604231,9129,70729,1326273,485618
155,California,CA-500,San Jose/Santa Clara City & County,6085,Santa Clara County,2012,1837605,922963,914642,1054384,52754,24658,623565,9293,72951,1348826,488779
156,California,CA-500,San Jose/Santa Clara City & County,6085,Santa Clara County,2013,1866050,937941,928109,1058324,53283,24696,645219,9526,75002,1373503,492547
157,California,CA-500,San Jose/Santa Clara City & County,6085,Santa Clara County,2014,1891286,952164,939122,1059146,53839,24487,667164,9713,76937,1396692,494594
158,California,CA-500,San Jose/Santa Clara City & County,6085,Santa Clara County,2015,1915736,965904,949832,1056665,53920,24105,692530,9826,78690,1420923,494813
159,California,CA-500,San Jose/Santa Clara City & County,6085,Santa Clara County,2016,1928144,973172,954972,1046215,54155,23985,713885,9942,79962,1436290,491854
160,California,CA-500,San Jose/Santa Clara City & County,6085,Santa Clara County,2017,1932251,977237,955014,1031579,54170,23515,732047,10134,80806,1444700,487551
161,California,CA-500,San Jose/Santa Clara City & County,6085,Santa Clara County,2018,1931985,978478,953507,1015887,54495,23080,746466,10158,81899,1449244,482741
162,California,CA-500,San Jose/Santa Clara City & County,6085,Santa Clara County,2019,1922411,974693,947718,996284,54176,22762,756911,10116,82162,1445642,476769
163,California,CA-500,San Jose/Santa Clara City & County,6085,Santa Clara County,2020,1907105,967756,939349,974387,54392,22631,764100,9825,81770,1435519,471586
437,California,CA-500,San Jose/Santa Clara City & County,6085,Santa Clara County,2021,1885508,960462,925046,952310,54190,22742,764874,9711,81681,1413990,471518
68,Massachusetts,MA-500,Boston,25025,Suffolk County,2007,728819,352294,376525,484036,173462,3455,54520,1052,12294,599686,129133
69,Massachusetts,MA-500,Boston,25025,Suffolk County,2008,742724,358993,383731,495425,174637,3545,55318,1073,12726,608836,133888
70,Massachusetts,MA-500,Boston,25025,Suffolk County,2009,753580,364415,389165,504664,175125,3649,55984,1103,13055,615108,138472
71,Massachusetts,MA-500,Boston,25025,Suffolk County,2010,722023,347689,374334,457720,178647,5408,61303,1120,17825,578568,143455
294,Massachusetts,MA-500,Boston,25025,Suffolk County,2011,737285,355153,382132,465052,182156,5507,63790,1148,19632,586205,151080
295,Massachusetts,MA-500,Boston,25025,Suffolk County,2012,751371,363044,388327,471152,186743,5664,65671,1185,20956,593845,157526
296,Massachusetts,MA-500,Boston,25025,Suffolk County,2013,762863,368605,394258,476223,190394,5858,66988,1268,22132,599543,163320
297,Massachusetts,MA-500,Boston,25025,Suffolk County,2014,774113,374407,399706,480451,194136,5988,68713,1289,23536,605074,169039
298,Massachusetts,MA-500,Boston,25025,Suffolk County,2015,783177,378773,404404,484612,196303,6033,69896,1322,25011,608918,174259
299,Massachusetts,MA-500,Boston,25025,Suffolk County,2016,793020,383513,409507,488826,198380,6062,71922,1348,26482,614492,178528
300,Massachusetts,MA-500,Boston,25025,Suffolk County,2017,801269,387322,413947,492879,199124,6033,73974,1342,27917,618686,182583
301,Massachusetts,MA-500,Boston,25025,Suffolk County,2018,804023,387683,416340,494829,198319,6081,74547,1328,28919,619044,184979
302,Massachusetts,MA-500,Boston,25025,Suffolk County,2019,805915,388735,417180,496554,196569,6142,75687,1282,29681,619777,186138
303,Massachusetts,MA-500,Boston,25025,Suffolk County,2020,801582,386458,415124,494074,193811,6096,76183,1256,30162,614822,186760
451,Massachusetts,MA-500,Boston,25025,Suffolk County,2021,771245,372309,398936,472598,188427,5983,73500,1243,29494,587719,183526
116,Texas,TX-503,Austin/Travis County,48453,Travis County,2007,970477,499994,470483,807536,86909,7541,51922,1119,15450,655960,314517
117,Texas,TX-503,Austin/Travis County,48453,Travis County,2008,998561,514874,483687,830346,88727,7964,53994,1194,16336,670122,328439
118,Texas,TX-503,Austin/Travis County,48453,Travis County,2009,1026158,529439,496719,852378,90426,8408,56448,1254,17244,684723,341435
119,Texas,TX-503,Austin/Travis County,48453,Travis County,2010,1024266,516637,507629,832727,91840,14509,61300,1094,22796,681500,342766
414,Texas,TX-503,Austin/Travis County,48453,Travis County,2011,1061662,535066,526596,862304,94669,14645,64609,1170,24265,704766,356896
415,Texas,TX-503,Austin/Travis County,48453,Travis County,2012,1096918,552429,544489,888894,98321,14885,68069,1212,25537,727655,369263
416,Texas,TX-503,Austin/Travis County,48453,Travis County,2013,1122346,565344,557002,908058,100430,14971,71130,1271,26486,743148,379198
417,Texas,TX-503,Austin/Travis County,48453,Travis County,2014,1152411,580509,571902,929490,103130,14941,75487,1339,28024,763310,389101
418,Texas,TX-503,Austin/Travis County,48453,Travis County,2015,1180003,594999,585004,948965,105285,15000,79847,1384,29522,781262,398741
419,Texas,TX-503,Austin/Travis County,48453,Travis County,2016,1206283,609022,597261,967157,107652,15086,84050,1411,30927,798765,407518
420,Texas,TX-503,Austin/Travis County,48453,Travis County,2017,1227373,619889,607484,981235,109558,15305,87940,1459,31876,813413,413960
421,Texas,TX-503,Austin/Travis County,48453,Travis County,2018,1246693,630111,616582,993836,111615,15371,91088,1523,33260,827082,419611
422,Texas,TX-503,Austin/Travis County,48453,Travis County,2019,1273567,643306,630261,1011932,114587,15577,95509,1623,34339,846834,426733
423,Texas,TX-503,Austin/Travis County,48453,Travis County,2020,1300503,656936,643567,1029364,117789,15682,100067,1666,35935,867144,433359
463,Texas,TX-503,Austin/Travis County,48453,Travis County,2021,1305154,662846,642308,1029295,118509,15724,102935,1726,36965,869717,435437
72,Michigan,MI-501,Detroit,26163,Wayne County,2007,1981238,953166,1028072,1083462,811443,7464,49235,1213,28421,1884001,97237
73,Michigan,MI-501,Detroit,26163,Wayne County,2008,1949024,937780,1011244,1070137,793058,7265,49243,1231,28090,1850674,98350
74,Michigan,MI-501,Detroit,26163,Wayne County,2009,1925848,926703,999145,1060806,779483,7034,49216,1241,28068,1825661,100187
75,Michigan,MI-501,Detroit,26163,Wayne County,2010,1820584,874161,946423,984224,742658,8193,46963,559,37987,1725324,95260
304,Michigan,MI-501,Detroit,26163,Wayne County,2011,1803003,866140,936863,978882,728341,8183,48504,428,38665,1707011,95992
305,Michigan,MI-501,Detroit,26163,Wayne County,2012,1795797,862986,932811,978499,718714,8280,50392,426,39486,1697745,98052
306,Michigan,MI-501,Detroit,26163,Wayne County,2013,1780131,855299,924832,972247,706582,8201,52421,414,40266,1681223,98908
307,Michigan,MI-501,Detroit,26163,Wayne County,2014,1771626,851846,919780,968895,698742,8246,54443,390,40910,1671653,99973
308,Michigan,MI-501,Detroit,26163,Wayne County,2015,1764866,848840,916026,964672,693268,8245,56335,376,41970,1663712,101154
309,Michigan,MI-501,Detroit,26163,Wayne County,2016,1760835,847808,913027,962951,687587,8204,58820,368,42905,1658113,102722
310,Michigan,MI-501,Detroit,26163,Wayne County,2017,1757874,846683,911191,960944,683779,8277,60603,378,43893,1653473,104401
311,Michigan,MI-501,Detroit,26163,Wayne County,2018,1755868,845721,910147,959025,681244,8320,61693,380,45206,1649619,106249
312,Michigan,MI-501,Detroit,26163,Wayne County,2019,1750093,842732,907361,954681,678508,8219,61864,397,46424,1642169,107924
313,Michigan,MI-501,Detroit,26163,Wayne County,2020,1740623,837721,902902,948590,673978,8165,61912,365,47613,1631561,109062
452,Michigan,MI-501,Detroit,26163,Wayne County,2021,1774816,859218,915598,970289,682152,8533,63558,245,50039,1660196,114620
